###########################
#S..........#.............#
#.###.#.###.#.###.#######.#
#.#.#.#.#.#.#.#...#.......#
#.#.#.###.#.#.#.###.###.#.#
#...#.......#.#.#...#...#.#
#.#########.#.###.#######.#
#.........#...#.#.........#
#####.###.#.###.###########
#.....###.#.#.#...........#
#.###.###.#.#.###########.#
#.#.#.....#.#.............#
###.#######.#.#.#########.#
#...........#.#.#.......#.#
#.#########.#.#.#.#####.#.#
#.#.........#.#.#.....#.#.#
#.#############.#####.#.#.#
#.#...#...#...#.......#.#.#
#.#.#.#.#.#.#.#########.#.#
#...#...#...#...........#F#
###########################