###########################
#S..........#.............#
#.###.#.###.#.###.#######.#
#.#.#.#.#.#.#.#...#.......#
#.#.#.###.#.#.#.###.###.#.#
#...#.......#.#.#...#...#.#
#.#########.#.###.#######.#
#.....#.........#.........#
#####.#.#######.###########
#.....#.#.....#...........#
#.#####.###.#.#############
#.#.#.......#.............#
#.#.#######.#.###########.#
#...........#.#.#.......#.#
###########.#.#.#.#####.#.#
#...........#.#.#.....#.#.#
#.#############.#####.#.#.#
#.#...#...#...#.......#.#.#
#.#.#.#.#.#.#.#########.#.#
#...#...#...#...........#F#
###########################